9 5 0 0 8 4
_X_X__X_X
_X___XX__
_X_X_X_X_
___X___X_
__X__XXX_