9 9 0 0 8 8
_X_X__X_X
_X___XX__
_X_X_X_X_
___X___X_
X_X__XXX_
__X_X____
_X__X_XX_
_______XX
X__XXX___